IIIIIIIIIIII
............
............
..R..GG..R..
.B.B.BB.B.B.
...RRRRRR...
BBBBBBBBBBBB
